1 1 1 1 1 1 1 1 1 1 1 1 1 0 0 0
1 1 1 1 1 1 1 1 1 1 1 1 0 0 0 0
1 1 1 1 1 1 1 1 1 1 1 1 1 0 0 0
1 1 1 1 1 1 1 1 1 1 1 1 1 1 1 1
1 1 1 1 1 1 1 1 1 1 1 1 1 1 1 1
4 4 4 4 4 4 4 4 4 4 4 4 4 4 4 2
4 4 4 4 4 4 4 4 4 4 4 4 4 4 5 2
2 2 2 2 2 2 2 2 2 2 2 2 2 5 5 2
2 2 2 2 2 2 2 2 2 2 2 2 2 5 5 2
2 2 2 3 3 3 2 2 2 2 2 2 2 5 5 2
2 2 3 3 3 3 3 2 2 2 2 2 2 5 5 2
2 3 3 3 3 3 3 2 2 2 2 2 2 5 5 2

